tileset.png 7 38 38
15 15
5	5	5	5	5	5	5	5	5	5	5	5	5	5	5
5	0	0	0	0	0	0	0	0	0	0	0	0	0	5
5	0	0	1	1	1	1	1	0	0	0	1	1	0	5
5	0	0	1	1	1	1	1	1	0	1	3	1	0	5
5	0	1	1	1	1	1	1	1	1	1	1	1	0	5
5	0	1	1	1	1	1	1	1	1	3	1	0	0	5
5	0	1	1	1	1	1	1	3	3	1	0	0	0	5
5	0	1	1	1	1	3	1	1	1	1	1	1	0	5
5	0	1	1	1	3	3	3	1	1	3	1	1	0	5
5	0	0	1	1	1	3	1	1	1	1	1	1	0	5
5	0	0	3	1	1	1	0	0	1	3	1	1	0	5
5	0	0	1	1	1	1	0	0	0	1	1	1	0	5
5	0	0	0	1	1	0	0	0	0	0	1	1	0	5
5	0	0	0	0	0	0	0	0	0	0	0	0	0	5
5	5	5	5	5	5	5	5	5	5	5	5	5	5	5